11111111111111111111
10003000000000000001
10000000000500000001
10000000000000000001
10000000000000000001
10001111100111110001
10001000000000010001
10001000222200010001
10001000022000010001
10000000000000000001
10000000004000000001
10000000000000000001
10001000030000010001
10001000000000010001
10001000000000010001
10001111100111110301
10000000222200000001
10000222222222200001
10022222222222222001
11111111111111111111