11111111111111111111
10003000000000000001
10000000000500000001
10000000000000000001
10000000000000000001
10001111100111110001
10001111100111110001
10000000000000000001
10000002222200000001
10000000000000000001
10000000004000000001
10000000000000000001
10001111111111110001
10001111111111110001
10001000000000000001
10000000000000000301
10000000000022222001
10000000000022222001
10000000000022222001
11111111111111111111