11111111111111111111
15223000010000002261
10201100010220110001
10201100010220110001
10000222222222200001
10000011111111000001
10002220011002220001
10002220011002220001
10001100000000110001
10001100040000110001
10222220011002222201
10222220011002222201
10000011111111030001
10000002222200000001
10000000000000000001
10000011111111000301
10022200011000222001
10111000011000111001
10070002222220080001
11111111111111111111